#############
#           #
#@       #  #
##########  #
     #T     #
     ########
