#########################################
#             #    #   #                #
#    @        #        #          ###   #
#             #    #   ### ###    # #   #
#             #    #   #     #    # #   #
#             #    #   #     #    # #   #
#             #    #   #     #    # # T #
#                  #   ### ######## #####
#             #    #                    #
#########################################
