#########################################
#             #    #   #                #
#    @        #        #          ###   #
#             #    #   ### ###    # #   #
#             #    #   #     #    # #   #
#             #    #   #     #    # #   #
#             #    #   #     #    # # T #
#             #    #   ### ######## #####
#             #    #                    #
#             #    #                    #
#             #    #                    #
#             #    #                    #
#             #    #                    #
#             #    #                    #
#             #    #                    #
#             #    #                    #
#             #    #                    #
#             #    #                    #
#             #    #                    #
#             #    #                    #
#             #    #                    #
#                  #                    #
#             #    #                    #
#             #    #                    #
#########################################
